F**---***
----*---*
***-*-*-*
*-*-***--
*-***---*
*-**--*--
*-*--**-*
***-*-***
***-----S